NO		 	 	 	 	 		 textures/supernario.png

WE textures/wariowhere.png

SO textures/fiShy.png

EA textures/mr.earnest.png

F 20,30,15
C 220,250,200




111111111111111111
100010010010110001
100000010000010001
100000100000010001
100001000000010001
100000000000010001
100010000000010001
100000000000010001
100000001000011111111111111111111111111111
1000000000000E0000000000000000000000000001
100000000000000001111111111111111111111111
100000010000100001
100000000000000001
100000000000000001
100000000000000001
100010010000000001
111100001111111111
10000001
10000001
111100011111111111
100100000000100001
100100111000100001
100000100000100001
100100100000000001
111111111111111111
