NO		 	 	 	 	 		 placeholder

WE placeholder2

SO placeholder3

EA placeholder4

F 220,100,0
C 250,30,0



111111111111111111
100010010000000001
100000000000000E11
100010010000000001
111100011111111111
10000001
10000001
111100011111111111
100100000000100001
100100111000100001
100000100000100001
100100100000000001
111111111111111111
