NO		 	 	 	 	 		 placeholder

WE placeholder2

SO placeholder3

EA placeholder4

F 220,100,0
C 250,30,0



111111111111111111111111111111111111111
100100000000000000000000000000100000001
100011000000000000000000000000100000001
100011000000000000000000000000100000001
100000100010000000000000010000111111111
100000000000000000000100000000000000001
10000000000000010000000000000000W000001
111101111111000000000010000000000000001
100000000001111111111111111111111111111
100000000001  1000010000001000000000001
100001111111111000010000001000000000001
100000000001000000010000001000000000001
100000000001000000010000001000000000001
100001111111000000010000001000000000001
100000111001110011111100111000000000001
100000010010000000000000001000000000001
100000010010011001110000001000000000001
100000000000010000010000001000000000001
100000000000010000010000001000000000001
100000000000010000010000001000000000001
111111111111111111111111111111111111111
