NO		 	 	 	 	 		 placeholder

WE placeholder2

SO placeholder3

EA placeholder4

F 220,100,0
C 250,30,0



111111111111111111 		 	 	 		  		 	  		 	 hahah
100010010000000001
100000000000000N01
100010010000000001   XDD
111111111001111111
XD    10000001
    hol110000011				hola
111111111001111111
100100000000100001                  11111111
100100111000100001                  10000001
100000100000100001                  1000111                               
100100100000000001                  11111111
111111111111111111 holyshit lois...
