NO		 	 	 	 	 		 textures/fake.png

WE textures/bogus.png

SO textures/fake.png

EA textures/bogus.png

F 130,150,0
C 25,230,77



111111111111111111
100010010010110001
100000010000010001
100000100000010001
100001000000010001
100000000000010001
100010000000010001
100000000000010001
100000001000011001
100000000000000001
100000000000000001
100000010000100001
100000000000000001
100000000000000001
100000000000000001
1000100100N0000001
111100011111111111
10000001
10000001
111100011111111111
100100000000100001
100100111000100001
100000100000100001
100100100000000001
111111111111111111
