NO		 	 	 	 	 		 placeholder

WE placeholder2

SO placeholder3

EA placeholder4

F 220,100,0
C 250,30,0



111111111111111111
1                1
1                1
1                1
1                1
1                1
1                1
1                1
1                1
1                1
1                1
1                1
1                1
1                1
1                1
1                1
1                1
111111111111111111
