NO		 	 	 	 	 		 placeholder

WE placeholder2

SO placeholder3

EA placeholder4

F 220,100,0
C 250,30,0



111111111111111111
10001001N000000001
100000000000000001
100010010000000001
111100011111111111
1000E001
10000001
111100011111111111
1001000000001000N1
100100111000100001
10000010W000100001
10010010000000S001
111111111111111111
