111111111111111111
100010C10000000001
1C0000000000000P01
100E10010000000001
111111111111111111
100100000000100001
100100111000100001
100000100000100001
100100100000000001
111111111111111111
