111111111111111111
100010C10000000001
1C000000000P000001
100E10010000000001
100000000000000001
100100000000100001
111111111111111111
