1111111111
1000000001
100000C001
100E0P0001
100000C001
1111111111
