11111111
10000001
100E0001
11000P01
1C10C001
11000001
11111111
